1,1,2,1,3,4,3,1,1,2,1,2,1,1,4,4,1,1,3,1
2,1,2,1,1,1,4,4,3,1,1,1,2,1,1,11,10
1,9,5,6,5,6,5,6,5,6,5,6,5,6,5,10,1
2,7,1,1,1,1,2,2,1,2,4,1,1,3,1,1,3
1,8,1,1,1,1,2,2,1,2,4,1,1,3,1,1,3
1,7,1,1,1,1,2,2,1,2,4,1,1,3,1,1,3
3,8,1,1,1,1,2,2,1,2,4,1,1,3,1,1,3
4,7,1,1,1,1,2,2,1,2,4,1,1,3,1,1,3
1,8,1,1,1,1,2,2,1,2,4,1,1,3,1,1,3
1,7,1,1,1,1,2,2,1,2,4,1,1,3,1,1,3